refrigerator	manmade
barn	building
bell	manmade
key	manmade
window	buildpart
screwdriver	tool
church	building
desk	furniture
cattle	animal
knife	kitchen
train	vehicle
beetle	insect
tomato	vegetable
foot	bodypart
eye	bodypart
dresser	furniture
spoon	kitchen
truck	vehicle
apartment	building
trousers	clothing
ant	insect
saw	tool
coat	clothing
closet	buildpart
dress	clothing
igloo	building
skirt	clothing
maize	vegetable
airplane	vehicle
car	vehicle
bear	animal
celery	vegetable
butterfly	insect
shirt	clothing
arm	bodypart
arch	buildpart
pliers	tool
glass	kitchen
house	building
cup	kitchen
horse	animal
bottle	kitchen
chisel	tool
cat	animal
bee	insect
lettuce	vegetable
bicycle	vehicle
hand	bodypart
chair	furniture
hammer	tool
door	buildpart
leg	bodypart
carrot	vegetable
watch	manmade
table	furniture
chimney	buildpart
bed	furniture
fly	insect
dog	animal
telephone	manmade
